#@#############
##..##.#.#..#.#
#.#...#.#..#.##
##.##...##.##.#
#...###..##...#
##..#.#.####.##
#.##..#...#.#.#
#.###...#.#####
###..#.#.######
##.#####.#..#.#
#.#.#..###....#
##..#......#..#
##.#####...##.#
#.#..###.##.###
###############
