#@#############
###..####..##.#
##.##...##.####
##.#..##.##.#.#
###...#.#.##.##
#...###.##.#.##
##.###.#..##..#
#.###...#...#.#
#..##....#.#..#
##.#......#####
#.####.###.#..#
#.............#
##.#.#...##...#
######.......##
###############
