#@#############
#.......#.....#
#.#######.###.#
#...#.......#.#
#.###.#######.#
#.#.....#.....#
#.#.#####.#####
#...#.....#...#
#.###.#####.###
#.#.#.#...#...#
#.#.#.#.#.###.#
#...#.#.#.#...#
#####.#.#.#.#.#
#.......#.....#
###############
