#@#############
##.##.##.#..###
#.#.#####.#.#.#
##..#.###..##.#
#..###.######.#
####.##..#...##
##.#...#.#.####
######.#.....##
#.#..#.#.######
###...#..#.##.#
#..##....##..##
#..#..#.#.##.##
#....##.#.#..##
##.......#.#.##
###############
