#@#############
#...#.....#...#
#.#.#.###.#.#.#
#.#.#.#...#.#.#
#.#.###.#####.#
#.#.....#.....#
#.#.#####.#####
#.#.#...#.....#
#.#.#.#.#####.#
#.#.#.#...#...#
#.###.#.###.###
#.....#.......#
#.###########.#
#...........#.#
###############
