#@#############
#.......#.....#
#######.###.#.#
#####.#....#..#
##....####.#.##
###.##.....#.##
##..#..####..##
#..##.#.......#
#.###.#.#.###.#
#.#...#.##.##.#
#...###.#.....#
#.####....###.#
#..###.##.....#
##........###.#
###############